16 9
################
#              #
#    #####     #
#    #   #  ####
#        #  #  #
#    #   ##B#  #
#    #    ###  #
#A   #         #
################
